board:
0 0 0 0 1  1 1 1 1 1  1 1
1 1 1 0 0  0 0 0 1 0  0 0
0 0 1 1 1  0 1 0 1 0  1 0
0 1 1 1 1  0 1 1 1 0  0 0
0 0 0 0 1  0 1 0 1 1  1 1
1 1 1 1 1  1 1 0 1 1  1 1
1 2 1 0 0  0 0 0 0 0  0 0

switches:
-1 -1
11 1 1 2 0 0 0 0 3 3 3 3
-1 -2
11 6 3 6 0 0 0 0 2 1 1 4
-2 -1
3 4 1 6 0 0 0 0 3 3 3 3
-3 -3
5 4 7 4 0 0 0 0 4 3 3 3
-3 -1
7 2 10 3 0 0 0 0 4 3 3 3

player:
0 0
